NO     ./textures/eagle.xpm
SO   ./textures/redbrick.xpm
F   128,0,05
WE   ./textures/purplestone.xpm
EA     ./textures/greystone.xpm

C                 192,82,8
111111111111111111111111111111111
11111111111001111111
10000000001000000000111111111111
11000000000000000000111
11000000011100W00000111
1100000001010000000111
11000000001000000000111
11000000000000000001111111111111111111111111111111111111111111
  1111111111111111111                   10000000001000000000111
111111111111111111111111111111111111111111111111111111111111