NO     ./textures/eagle.xpm
SO   ./textures/redbrick.xpm
F   128,0,05
WE   ./textures/purplestone.xpm
EA     ./textures/greystone.xpm
C                 192,82,81

11111111111111111111111111111111111111111111
11
101
1011
10011111
10N00001
11111111