NO     ./textures/1.xpm
SO   ./textures/2.xpm





WE   ./textures/3.xpm




EA     ./textures/4.xpm

F   128,45,05











C   192,82,82











11111 1111                 11111111111111111111111111111111111
11
1W1
101                     1
1001111                                      1
10000001
1111111                  1












