NO     ./textures/eagle.xpm
SO   ./textures/redbrick.xpm
F   128,0,05
WE   ./textures/purplestone.xpm
EA     ./textures/greystone.xpm

C                 192,82,82



111111111111111111111111111
100000111010W0000011
110000000010H0000000111
1100000000D000000H00111
11000H00011100000000111
11000000010100000000111
11000H000010000H0000111
1100000000D0000H000011111111111111111111
10000000001000000000000000000000000000001
1111111111111111111111111111111111111111